{
  "id": "sample_guide",
  "name": "示例攻略",
  "season": "模板",
  "note": "这是示例文件。请用真实地图导出的 JSON 替换或导入自己的攻略。",
  "signature": [
    112,118,126,132,136,139,142,145,
    108,116,124,131,137,141,144,146,
    104,112,122,130,139,145,149,151,
    101,109,120,132,145,151,155,157,
    102,111,121,133,144,150,154,158,
    106,114,123,131,139,145,150,153,
    110,118,126,132,136,141,146,150,
    113,120,128,133,137,140,144,148
  ],
  "tips": [
    "这是模板攻略。",
    "在真实地图里点击“导出攻略 JSON”，再编辑导出的文件。",
    "导入后点击“匹配攻略”测试是否能匹配。"
  ]
}
